108 109 110 111 110 111 110 111 110 111 110 111 110 111 110 111 110 111 110 111 110 111 110 111 110 111 110 111 110 111 112 113 108 109 110 111 110 111 110 111 110 111 110 111 110 111 110 111 110 111 110 111 110 111 110 111 110 111 110 111 110 111 112 113 108 109 110 111 110 111 110 111 110 111 110 111 110 111 110 111 110 111 110 111 110 111 110 111 110 111 110 111 110 111 112 113 108 109 110 111 110 111 110 111 110 111 110 111 110 111 110 111 110 111 110 111 110 111 110 111 110 111 110 111 110 111 112 113
120 11 75 11 11 11 11 11 11 11 11 11 11 11 11 11 11 11 11 11 11 11 11 11 11 97 11 11 98 11 11 125 120 11 75 11 11 11 11 11 11 11 11 11 11 11 11 11 11 11 11 11 11 11 11 11 11 97 11 11 98 11 11 125 120 11 75 11 11 11 11 11 11 11 11 11 11 11 11 11 11 11 11 11 11 11 11 11 11 97 11 11 98 11 11 125 120 11 75 11 11 11 11 11 11 11 11 11 11 11 11 11 11 11 11 11 11 11 11 11 11 97 11 11 98 11 11 125
132 133 134 135 134 135 134 135 134 135 134 135 134 135 134 135 134 135 134 135 134 135 134 135 134 135 134 135 134 135 136 137 132 133 134 135 134 135 134 135 134 135 134 135 134 135 134 135 134 135 134 135 134 135 134 135 134 135 134 135 134 135 136 137 132 133 134 135 134 135 134 135 134 135 134 135 134 135 134 135 134 135 134 135 134 135 134 135 134 135 134 135 134 135 136 137 132 133 134 135 134 135 134 135 134 135 134 135 134 135 134 135 134 135 134 135 134 135 134 135 134 135 134 135 134 135 136 137
11 11 11 11 11 11 11 11 11 11 11 11 11 11 11 11 157 144 11 11 11 11 145 144 11 11 11 11 11 11 11 11 11 11 11 11 11 11 11 11 11 51 11 4 11 11 11 11 11 11 11 11 4 11 11 11 11 11 11 11 11 11 11 144 11 11 11 11 11 11 11 11 11 11 11 11 11 11 11 11 11 11 11 11 11 11 11 11 11 11 11 11 11 11 11 11 11 11 11 11 11 11 11 11 11 11 11 11 11 11 11 11 11 11 11 11 11 11 11 11 11 11 11 11 11 11 11 91
11 11 11 11 11 11 11 11 11 11 11 11 11 11 11 11 156 145 11 11 11 11 144 145 11 98 11 11 98 11 11 11 11 11 11 74 11 121 122 11 11 11 11 16 11 88 11 11 11 11 88 11 16 11 11 11 11 11 11 11 11 11 11 11 11 11 11 11 11 11 11 11 11 11 11 11 11 11 11 11 11 11 11 11 11 11 11 11 11 11 11 11 11 11 11 11 11 11 11 11 11 11 11 11 11 11 11 11 11 11 11 11 11 11 11 11 11 11 11 11 11 11 11 11 11 11 11 103
11 11 11 11 11 11 11 11 11 11 11 11 11 11 11 11 157 144 11 11 15 15 145 144 74 11 11 11 15 11 15 11 11 11 11 11 11 11 11 11 11 11 11 4 11 100 11 11 11 11 100 11 4 11 11 11 11 11 62 63 11 11 11 11 11 11 11 11 11 11 11 11 11 11 11 11 11 11 11 11 11 11 11 11 11 11 11 11 11 11 11 11 11 11 11 11 11 11 11 11 11 11 11 11 11 11 11 11 11 11 11 11 11 11 11 11 11 11 11 11 11 11 11 11 11 11 11 103
11 11 11 11 11 11 11 11 11 11 11 11 11 11 156 157 156 145 11 11 144 145 144 145 144 145 144 145 144 145 144 145 11 11 11 11 15 11 11 11 11 11 11 16 62 63 11 11 27 28 11 11 16 11 121 122 11 11 11 11 11 11 11 11 11 11 11 11 11 11 11 11 97 11 11 11 11 11 11 11 11 11 11 11 11 11 11 11 11 11 11 11 11 11 11 11 11 11 11 11 11 11 11 11 11 11 11 11 11 11 11 11 11 11 11 11 11 11 11 11 11 11 11 11 11 11 11 103
11 11 11 11 11 11 11 11 11 11 11 11 11 156 157 144 145 144 11 11 11 11 145 144 145 144 145 144 145 144 145 144 11 11 11 144 145 11 11 74 11 11 11 4 11 11 11 11 39 40 11 11 4 11 11 11 11 11 11 11 11 11 11 11 11 11 11 11 11 11 11 11 11 11 11 11 11 74 11 11 11 11 74 11 11 11 11 74 11 11 11 11 74 11 11 11 11 11 11 11 11 11 11 11 11 11 11 11 11 11 11 11 11 11 11 11 11 11 11 11 11 11 11 11 11 11 11 103
11 11 11 11 11 11 11 11 156 157 156 157 156 157 144 145 11 11 11 11 11 88 121 122 11 51 11 11 11 11 11 11 11 11 11 11 11 11 11 11 11 11 11 16 11 74 11 5 6 11 74 11 16 11 11 11 11 11 11 11 11 11 11 145 144 145 144 145 144 145 144 11 11 11 11 11 11 11 11 11 11 11 11 11 11 11 11 11 11 11 11 11 11 11 11 11 11 11 11 11 11 11 11 11 11 11 11 11 11 11 11 11 11 11 11 11 11 11 11 11 11 11 11 11 11 11 11 103
11 11 157 156 157 156 157 156 157 144 145 144 145 144 11 11 11 62 63 11 11 100 11 11 11 11 11 11 11 11 27 28 11 11 11 11 74 11 11 15 11 11 11 4 11 11 11 17 18 11 11 11 4 11 11 11 27 28 144 145 11 11 145 156 157 144 145 144 145 144 145 144 145 11 11 11 144 145 11 11 11 144 145 11 11 11 144 145 11 11 11 144 145 11 11 11 144 145 144 145 11 11 11 11 11 11 11 11 11 11 11 11 11 11 11 11 11 11 11 11 11 11 11 11 11 11 11 103
11 157 156 145 144 145 144 145 144 145 11 4 11 145 11 11 11 11 11 11 11 11 11 11 11 11 11 11 11 11 39 40 11 11 11 11 11 11 11 145 145 11 11 151 151 151 151 151 151 151 151 151 151 11 15 15 39 40 11 11 74 11 144 157 156 145 11 11 11 11 11 11 11 11 11 11 11 11 11 11 11 11 11 11 11 11 11 11 11 11 11 11 11 11 11 11 11 144 145 11 11 11 11 11 11 11 11 11 11 11 11 11 11 11 11 11 11 11 11 11 11 11 11 11 11 11 11 103
157 156 145 144 10 10 4 10 10 11 11 16 11 144 74 11 11 11 11 74 11 11 15 15 11 11 11 11 15 11 11 11 11 11 11 15 15 11 11 11 11 11 11 11 11 11 11 11 11 11 11 11 11 11 145 144 11 11 11 11 11 11 145 156 157 144 11 11 11 11 11 11 11 11 11 11 11 11 11 11 11 11 27 28 11 11 11 11 11 11 11 11 11 11 11 11 11 11 11 11 11 11 11 11 11 11 11 11 11 11 11 11 11 11 11 11 11 11 11 11 11 11 11 11 11 11 11 103
156 145 144 11 11 11 16 11 11 27 28 4 11 145 144 145 144 145 144 145 11 11 144 145 11 11 144 145 144 11 11 11 11 11 11 145 144 145 11 11 121 122 11 11 11 11 11 11 11 11 11 11 11 11 11 11 11 15 15 11 11 11 144 157 156 145 11 11 11 11 11 11 11 0 1 2 11 11 11 11 11 11 39 40 11 11 0 1 2 11 11 11 11 11 11 11 11 11 11 11 11 11 11 11 11 11 11 11 11 11 11 11 11 11 11 11 11 11 11 11 11 11 11 11 11 11 11 103
157 144 11 11 11 11 4 74 11 39 74 16 11 11 11 11 11 11 11 11 11 11 0 1 2 11 11 144 145 144 74 11 11 74 145 144 145 51 11 11 11 11 11 11 11 11 11 11 11 11 11 11 11 11 11 11 11 144 145 11 11 11 145 156 157 144 11 11 27 28 11 11 11 12 13 14 11 11 11 11 11 11 11 11 11 11 12 13 14 11 11 11 27 28 11 11 11 11 11 11 11 11 11 11 11 11 11 11 11 11 11 11 11 11 11 11 11 11 11 11 11 11 11 11 11 11 11 103
156 145 11 11 11 11 151 151 151 151 151 151 11 11 11 11 121 122 11 11 11 11 12 13 14 11 11 11 144 145 144 145 144 145 144 145 11 11 11 11 11 11 11 11 11 11 11 11 11 11 11 11 11 11 11 11 11 11 11 11 11 11 144 157 156 145 11 11 39 40 11 88 11 24 25 26 11 88 11 11 11 11 11 11 88 11 24 25 26 11 88 11 39 40 11 11 11 11 11 11 11 11 11 11 11 11 11 11 11 11 11 11 11 11 11 11 11 11 11 11 11 11 11 11 11 11 11 103
157 144 11 11 11 11 11 11 11 11 0 1 2 11 11 11 11 11 11 11 11 11 24 25 26 11 11 11 11 144 145 156 157 144 145 11 11 11 11 0 1 2 11 11 11 27 28 11 11 11 11 11 11 11 74 1 2 11 11 11 145 144 145 156 157 144 11 11 11 11 11 100 11 36 37 38 11 100 27 28 11 11 11 11 100 11 36 37 38 11 100 11 11 11 11 11 11 11 11 11 11 11 11 11 11 11 11 11 11 11 11 11 11 11 11 11 11 11 11 11 11 11 11 11 11 11 11 103
156 145 144 145 11 27 28 11 11 11 12 13 14 11 11 88 11 27 28 11 11 11 36 37 38 11 62 63 88 11 144 145 144 145 11 11 88 11 11 12 13 14 11 11 11 39 40 11 88 11 11 11 11 11 12 13 14 15 15 11 88 11 144 157 156 145 11 11 11 11 11 11 11 48 49 50 11 11 39 40 11 11 11 11 11 11 48 49 50 11 11 11 11 11 11 11 11 11 11 11 11 11 11 11 11 11 11 11 11 11 11 11 11 11 11 11 11 11 11 11 11 11 11 11 11 11 11 103
145 144 11 51 11 39 144 145 11 11 24 25 26 11 11 100 11 39 40 11 11 11 48 49 50 11 11 11 100 11 11 144 145 11 11 11 100 11 11 24 25 26 11 11 11 11 11 11 100 11 11 11 11 11 24 25 26 145 144 11 100 11 145 156 157 144 11 11 11 11 11 11 11 11 11 11 11 11 11 11 11 11 11 11 11 11 11 11 11 11 11 11 11 11 11 11 11 11 11 11 11 11 11 11 11 11 11 11 11 11 11 11 11 11 11 11 11 11 11 11 11 11 11 11 11 11 11 103
144 11 11 11 11 11 11 11 11 11 36 37 38 11 11 11 11 11 11 11 11 11 74 11 11 74 11 11 11 11 11 11 11 11 11 11 11 11 11 36 37 38 11 11 11 11 11 11 11 27 28 11 11 11 36 37 38 11 11 11 11 11 144 157 156 145 11 11 11 11 11 11 11 11 74 11 11 11 11 11 74 11 11 11 11 11 74 11 11 11 11 11 11 11 11 11 11 11 11 11 11 11 11 11 11 11 11 11 11 11 11 11 11 11 11 11 11 11 11 11 11 11 11 11 11 11 11 103
145 62 63 11 11 11 97 11 144 145 144 49 50 11 11 11 11 11 11 11 11 11 15 11 11 11 11 15 11 11 11 11 11 11 11 62 63 11 11 48 49 50 11 11 97 11 11 11 11 39 40 11 11 11 48 49 50 11 11 11 11 144 145 156 157 144 145 11 11 11 11 11 11 11 11 11 11 11 11 11 11 11 11 11 11 11 11 11 11 11 11 11 11 11 11 11 11 11 11 11 11 11 11 11 11 11 11 11 11 11 11 11 11 11 11 11 11 11 11 11 11 11 11 11 11 11 11 103
144 11 11 11 84 85 86 87 11 11 11 11 11 11 11 11 11 11 11 11 144 145 144 145 144 145 144 145 11 11 11 11 11 11 11 11 11 11 11 11 11 11 11 84 85 86 87 11 11 11 11 11 11 11 11 11 11 11 11 11 144 145 156 157 156 157 144 145 11 11 11 11 11 84 85 86 87 11 11 84 85 86 87 11 11 84 85 86 87 11 11 11 11 11 11 11 11 11 11 11 11 11 11 11 11 11 11 11 11 11 11 11 11 11 11 11 11 11 11 11 11 11 11 11 11 11 11 103
145 11 11 11 96 11 11 99 15 11 11 15 11 11 11 11 15 11 11 144 145 156 157 156 157 156 157 144 145 11 15 11 15 15 15 11 11 15 11 15 11 11 15 96 15 15 99 15 15 15 15 15 11 11 11 11 11 11 15 144 145 156 157 156 157 156 157 144 145 11 11 11 11 96 11 11 99 11 11 96 11 11 99 11 11 96 11 11 99 11 11 11 11 11 11 11 11 11 11 11 11 11 11 11 11 11 11 11 11 11 11 11 11 11 11 11 11 11 11 11 11 11 11 11 11 11 11 115
144 145 144 145 144 145 144 145 144 145 144 145 144 145 144 145 144 145 156 157 156 157 11 11 11 11 156 157 156 157 144 145 144 145 144 145 144 145 144 145 144 145 144 145 144 145 144 145 144 145 144 145 144 11 11 11 11 145 144 145 156 157 156 157 156 157 156 157 144 145 144 145 144 145 144 145 144 145 144 145 144 145 144 145 144 145 144 145 144 145 144 145 144 145 144 145 144 145 144 145 144 145 144 145 144 145 144 145 11 11 11 11 144 145 144 145 144 145 144 145 144 145 144 145 144 145 144 145
157 156 157 156 157 156 157 156 157 156 157 156 157 156 157 156 157 156 157 156 157 11 11 11 11 11 11 156 157 156 157 156 157 156 157 156 157 156 157 156 157 156 157 156 157 156 157 156 157 156 157 156 157 144 11 11 145 156 157 156 157 156 157 156 157 156 157 156 157 156 157 156 157 156 157 156 157 156 157 156 157 156 157 156 157 156 157 156 157 156 157 156 157 156 157 156 157 156 157 156 157 156 157 156 157 156 157 156 157 11 11 156 157 156 157 156 157 156 157 156 157 156 157 156 157 156 157 156
108 109 110 111 110 111 110 111 110 111 110 111 110 111 110 111 110 111 110 111 110 111 110 111 110 111 110 111 110 111 112 113 108 109 110 111 110 111 110 111 110 111 110 111 110 111 110 111 110 111 110 111 110 111 110 111 110 111 110 111 110 111 112 113 108 109 110 111 110 111 110 111 110 111 110 111 110 111 110 111 110 111 110 111 110 111 110 111 110 111 110 111 110 111 112 113 108 109 110 111 110 111 110 111 110 111 110 111 110 111 110 111 110 111 110 111 110 111 110 111 110 111 110 111 110 111 112 113
120 11 75 11 11 11 11 11 11 11 11 11 11 11 11 11 11 11 11 11 11 11 11 11 11 97 11 11 98 11 11 125 120 11 75 11 11 11 11 11 11 11 11 11 11 11 11 11 11 11 11 11 11 11 11 11 11 97 11 11 98 11 11 125 120 11 75 11 11 11 11 11 11 11 11 11 11 11 11 11 11 11 11 11 11 11 11 11 11 97 11 11 98 11 11 125 120 11 75 11 11 11 11 11 11 11 11 11 11 11 11 11 11 11 11 11 11 11 11 11 11 97 11 11 98 11 11 125
132 133 134 135 134 135 134 135 134 135 134 135 134 135 134 135 134 135 134 135 134 135 134 135 134 135 134 135 134 135 136 137 132 133 134 135 134 135 134 135 134 135 134 135 134 135 134 135 134 135 134 135 134 135 134 135 134 135 134 135 134 135 136 137 132 133 134 135 134 135 134 135 134 135 134 135 134 135 134 135 134 135 134 135 134 135 134 135 134 135 134 135 134 135 136 137 132 133 134 135 134 135 134 135 134 135 134 135 134 135 134 135 134 135 134 135 134 135 134 135 134 135 134 135 134 135 136 137
11 11 11 11 11 11 11 11 11 11 11 11 11 11 158 159 158 159 11 11 11 11 11 11 11 11 11 11 11 11 11 11 11 11 11 4 11 11 11 11 11 11 11 11 11 11 11 11 11 11 4 11 11 11 11 11 11 11 11 11 11 11 11 11 11 11 11 11 11 11 11 11 11 11 11 11 11 11 11 11 11 11 11 11 11 11 11 11 11 11 11 11 11 11 11 11 11 11 11 11 11 12 13 14 11 11 11 88 11 11 11 11 11 11 11 11 11 11 11 11 11 11 11 11 11 11 11 11
11 11 158 159 158 159 11 11 11 11 11 158 159 158 159 149 150 158 159 158 159 11 11 11 11 11 158 159 158 159 11 11 11 11 11 16 11 11 11 11 11 11 11 11 11 11 11 11 11 11 16 11 11 11 11 11 11 11 11 11 11 11 11 11 11 11 11 11 11 11 11 11 11 11 11 11 11 11 11 11 11 11 11 11 11 11 11 11 11 11 11 11 11 11 11 11 11 11 11 11 11 24 25 26 11 11 11 100 11 11 11 11 11 11 11 11 11 11 11 11 11 11 11 11 11 11 11 11
158 159 160 149 150 160 158 159 160 158 159 160 149 150 148 161 162 148 149 150 160 158 159 160 158 159 160 149 150 160 158 159 11 11 11 4 11 11 11 11 11 11 11 74 11 11 11 11 11 11 4 11 11 11 146 147 11 11 11 11 11 11 11 11 11 11 11 11 11 11 11 11 11 11 11 11 11 11 11 11 11 11 11 11 11 11 11 11 11 11 11 11 11 11 11 11 11 11 11 11 11 36 37 38 11 11 11 11 11 11 74 11 11 11 11 11 11 11 11 11 11 11 11 11 11 11 11 11
159 146 147 161 162 146 147 149 150 160 146 147 161 162 11 11 11 11 161 162 146 147 160 149 150 146 147 161 162 146 147 158 11 11 11 16 11 11 11 11 11 74 11 11 11 74 11 11 11 11 16 11 11 148 158 159 148 11 11 11 11 11 11 11 11 11 11 11 11 11 11 11 11 11 11 11 11 11 11 11 11 11 11 11 11 11 11 11 11 0 1 2 11 11 11 11 88 11 11 11 11 48 49 50 11 11 11 11 11 11 11 11 11 11 11 11 11 11 11 11 11 11 11 11 11 11 11 11
149 150 148 11 11 4 11 161 162 146 147 11 4 11 11 11 11 11 11 4 11 146 147 161 162 11 4 11 11 148 149 150 11 11 11 4 11 11 11 74 11 11 11 11 11 11 11 74 11 11 4 11 11 11 146 147 11 11 11 11 11 11 11 11 11 11 11 11 11 11 11 11 11 11 11 11 11 11 11 11 11 11 11 11 11 11 11 11 11 12 13 14 11 11 11 11 100 11 11 11 11 11 74 11 11 11 11 146 147 146 147 146 147 11 11 11 11 11 11 11 11 11 11 11 11 11 11 11
161 162 11 11 11 16 11 4 11 11 11 11 16 11 74 11 11 11 11 16 11 11 11 11 4 11 16 11 11 11 161 162 11 11 11 16 11 74 11 11 11 11 11 11 11 11 11 11 11 74 16 11 11 11 11 11 11 11 11 11 11 27 28 11 11 11 11 11 11 11 11 11 11 11 11 11 11 11 11 11 11 11 11 11 11 11 11 11 11 24 25 26 11 11 11 11 11 11 11 11 11 11 11 11 11 11 11 11 11 11 11 11 11 11 11 11 11 11 11 11 11 11 11 11 11 11 11 11
91 92 11 63 11 4 74 16 11 11 11 11 4 11 11 11 11 74 11 4 11 11 11 11 16 74 4 11 11 11 91 92 11 11 151 151 151 151 151 151 151 151 151 151 151 151 151 151 151 151 151 151 151 11 11 11 11 11 11 11 11 39 40 11 11 11 11 11 11 11 11 11 11 11 11 11 11 11 11 11 11 11 11 11 11 11 11 11 11 36 37 38 11 11 11 11 74 11 11 11 11 146 147 146 147 11 11 11 11 11 11 11 11 11 11 11 11 11 11 11 11 11 11 11 11 11 11 11
103 104 11 11 11 16 11 4 11 11 88 11 151 151 151 11 11 11 11 16 11 88 11 11 4 11 16 11 11 11 103 104 11 11 11 11 11 11 11 11 11 11 11 11 11 11 11 11 11 11 11 11 11 11 11 11 11 11 11 11 11 11 11 11 11 11 11 11 11 11 11 11 11 11 11 11 11 0 1 2 11 11 11 11 88 11 11 11 11 48 49 50 11 11 11 11 11 11 11 11 11 11 11 11 11 11 11 11 11 11 11 11 11 11 11 11 11 11 11 11 11 11 11 11 11 11 11 11
91 92 11 11 11 151 151 151 1 2 100 11 62 63 11 11 11 151 151 151 151 100 0 1 151 151 151 11 11 11 91 92 10 10 11 11 11 11 11 11 11 11 27 28 11 11 11 11 11 11 11 11 11 11 11 11 11 11 11 11 11 97 11 11 11 11 97 11 11 11 11 11 11 11 11 11 11 12 13 14 11 11 11 11 100 11 11 11 11 11 74 11 11 11 11 146 147 146 147 11 11 11 11 11 11 11 11 11 11 11 11 11 11 11 11 11 11 11 11 11 11 11 11 11 11 11 11 11
103 104 74 11 11 121 122 12 13 14 11 11 11 11 11 11 11 11 11 11 11 11 12 13 14 121 122 11 11 74 103 104 10 10 11 11 11 11 11 11 88 11 39 40 11 11 11 11 11 11 11 11 11 11 88 11 11 11 11 11 11 11 11 11 11 11 11 11 11 11 11 11 11 11 11 11 11 24 25 26 11 11 11 11 11 11 11 11 11 11 11 11 11 11 11 11 11 11 11 11 11 11 11 11 11 11 11 11 11 11 11 11 11 11 11 11 11 11 11 11 11 11 11 11 11 11 11 11
115 116 11 11 11 11 11 24 25 26 11 11 11 11 11 11 11 11 11 11 11 11 24 25 26 11 11 11 11 11 115 116 10 97 11 11 11 11 11 11 100 11 11 11 11 11 11 11 11 11 27 28 11 11 100 11 11 11 11 11 11 11 11 11 11 11 11 11 11 11 11 11 11 11 11 11 11 36 37 38 11 11 11 11 74 11 11 11 11 146 147 146 147 11 11 11 11 11 11 11 11 11 11 11 11 11 11 11 11 11 11 11 11 11 11 11 11 11 11 11 11 11 11 11 11 11 11 11
159 146 147 146 147 11 11 36 37 38 11 11 11 11 11 5 6 11 11 11 11 11 36 37 38 11 11 146 147 146 147 160 160 146 147 146 147 11 11 11 11 11 11 11 11 11 11 11 11 11 39 40 11 11 11 11 11 11 11 146 147 146 147 160 160 146 147 146 147 11 11 11 88 11 11 11 11 48 49 50 11 11 11 11 11 11 11 11 11 11 11 11 11 11 11 11 11 11 11 11 11 11 11 11 11 11 11 11 11 11 11 11 11 11 11 11 11 11 11 11 11 11 11 11 11 11 11 11
149 150 146 147 11 11 11 48 49 50 11 11 11 11 11 17 18 11 11 11 11 11 48 49 50 11 11 11 146 147 149 150 149 150 146 147 11 11 11 11 11 11 11 11 11 11 11 11 11 11 11 11 11 11 11 11 11 11 11 11 146 147 149 150 149 150 146 147 11 11 11 11 100 11 11 11 11 11 74 11 11 11 11 146 147 146 147 11 11 11 11 11 11 11 11 11 11 11 11 11 11 11 11 11 11 11 11 11 11 11 11 11 11 11 11 11 11 11 11 11 11 11 11 11 11 11 11 11
161 162 11 11 11 11 88 11 11 11 11 11 11 11 11 91 92 11 11 11 11 11 11 11 11 88 11 11 11 11 161 162 161 162 11 11 11 11 11 11 11 11 11 11 11 11 11 11 11 11 11 11 11 11 11 11 11 11 11 11 11 11 161 162 161 162 11 11 11 11 11 11 11 11 11 11 11 11 11 11 11 11 11 11 11 11 11 11 11 11 11 11 11 11 11 11 11 11 11 11 11 11 11 11 11 11 11 11 11 11 11 11 11 11 11 11 11 11 11 11 11 11 11 11 11 11 11 11
147 11 11 11 11 11 100 11 11 11 11 91 92 11 11 91 92 11 11 91 92 11 11 11 11 100 11 11 11 11 11 146 147 11 88 11 11 11 52 53 11 11 11 11 11 11 11 52 53 11 11 11 11 11 11 11 52 53 11 11 11 88 11 146 147 11 11 11 11 11 11 11 74 11 11 11 11 146 147 146 147 11 11 11 11 11 11 11 11 11 11 11 11 11 11 11 11 11 11 11 11 11 11 11 11 11 11 11 11 11 11 11 11 11 11 11 11 11 11 11 11 11 11 11 11 11 11 11
146 11 11 11 11 11 11 11 11 11 11 91 92 11 11 103 104 11 11 91 92 11 11 11 11 11 11 11 11 11 11 11 11 11 100 11 11 11 64 65 11 11 11 11 11 11 11 64 65 11 11 11 11 11 11 11 64 65 11 11 11 100 11 11 11 11 11 11 11 11 11 11 11 11 11 11 11 11 11 11 11 11 11 11 11 11 11 11 11 11 11 11 11 11 11 11 11 11 11 11 11 11 11 97 11 11 74 11 11 11 11 11 11 11 11 11 11 11 11 11 11 11 11 11 11 11 11 11
147 11 11 11 11 11 11 91 92 11 11 103 104 11 11 91 92 11 11 103 104 11 11 91 92 11 11 11 11 11 11 11 11 11 11 11 11 11 91 92 11 11 11 11 11 11 11 91 92 11 11 11 11 11 11 11 91 92 11 11 11 11 11 11 11 11 11 11 11 11 11 146 147 146 147 11 11 11 11 11 11 11 11 11 11 11 11 11 11 11 11 11 11 11 11 11 11 11 11 11 11 11 11 11 11 11 11 11 11 11 11 11 11 11 11 11 11 11 11 11 11 11 11 11 11 11 11 11
146 11 11 11 11 11 11 103 104 11 11 91 92 11 11 103 104 11 11 91 92 11 11 103 104 11 11 11 11 62 63 11 11 11 11 11 11 11 103 104 11 11 11 11 11 11 11 103 104 11 11 11 11 11 11 11 103 104 11 11 11 11 11 11 11 11 11 11 11 11 11 11 11 11 11 11 11 11 11 11 11 11 11 11 11 11 11 11 11 11 11 11 11 11 11 11 11 11 11 11 11 84 85 86 85 86 85 86 87 11 11 11 11 11 11 11 11 11 11 11 11 11 11 11 11 11 11 11
147 11 15 15 11 11 11 115 116 11 15 115 116 11 11 115 116 15 15 115 116 15 11 115 116 15 11 11 15 15 15 11 11 11 11 11 11 11 115 116 11 11 11 11 11 11 11 115 116 11 11 11 11 11 11 11 115 116 11 11 11 11 11 11 11 11 11 11 11 11 11 11 11 11 11 11 11 11 11 11 11 11 11 11 11 11 11 11 11 11 11 11 11 11 11 11 11 11 11 11 11 96 11 11 11 11 11 11 99 11 11 11 11 11 11 11 11 11 11 11 11 11 11 11 11 11 11 11
146 147 149 150 146 147 146 147 149 150 146 147 146 147 148 149 150 148 146 147 146 147 149 150 146 147 146 147 149 150 146 147 146 147 149 150 146 147 149 150 146 147 149 150 146 147 149 150 146 147 149 150 146 147 149 150 146 147 149 150 146 147 149 150 146 147 149 150 146 147 149 150 146 147 149 150 146 147 149 150 146 147 149 150 146 147 149 150 146 147 149 150 146 147 149 150 146 147 149 150 146 147 149 150 146 147 149 150 146 147 149 150 146 147 149 150 146 147 149 150 146 147 149 150 146 147 149 150
159 160 161 162 160 158 159 160 161 162 160 158 159 158 159 161 162 158 159 158 159 160 161 162 160 158 159 160 161 162 160 158 159 160 161 162 159 160 161 162 159 160 161 162 159 160 161 162 159 160 161 162 159 160 161 162 159 160 161 162 159 160 161 162 159 160 161 162 159 160 161 162 159 160 161 162 159 160 161 162 159 160 161 162 159 160 161 162 159 160 161 162 159 160 161 162 159 160 161 162 159 160 161 162 159 160 161 162 159 160 161 162 159 160 161 162 159 160 161 162 159 160 161 162 159 160 161 162
